###################      ####################
#       ##        #      #    # $#          #
# >     ##        ########      #           #
#                   !                       #
#                      ##                  N#
#                   # #                     #
#                         W                 #
#############################################