#############################################
#      ##  $          #           #    N    #
#V>       ##                         P!     #
#                      ##                   #
#############################################