#############################################
#      ##  $          #       S   #         #
#         ## ^                        !   N #
#            V         ##                   #
#############################################