#############################################
#      ##  $         V#      #    #         #
#         ##         >                ! B   #
#                      ##         #         #
#############################################