#############################################
#      ##             #    !      #$#       #
#V>       ##                       D #      #
#                      N##                  #
#############################################