#############################################
#      ##            V#      #    #         #
#         ##                            <   #
#                      ##         #         #
#############################################
