#############################################
#      ##             #           # #       #
#V        ##           >             #      #
#                      N##                  #
#############################################
