#############################################
#      ##             #           #    N    #
#V        ##                         P      #
#                      ##           >       #
#############################################
