#############################################
#      ##             #           #         #
#         ##                             >N #
#            V         ##                   #
#############################################
